+-+-+-+-+-+-+-+-+-+-+-+-+-+-+-+-+-+-+-+-+-+-+-+-+-+-+-+-+-+-+
  |     |               |         |     |       |     |     |
+ + +-+ + +-+ +-+-+-+-+ + +-+-+-+ + +-+ + +-+-+ + + + + +-+ +
|     | |   |         | | |     | | | | | | |     | |   | | |
+-+-+-+ +-+ +-+-+-+-+ + + + + +-+ + + + + + + +-+-+ +-+ + + +
|       |   |       | | | | | |   |   |   | |   |   |   |   |
+ +-+-+-+ +-+ +-+-+ + +-+ + + + +-+-+-+ + + +-+ +-+-+ + +-+-+
|   |         |     |     | |   |       | |   |   |   |     |
+-+ + + + +-+-+ + + +-+-+-+ +-+-+ +-+-+-+-+-+ +-+ + +-+-+-+ +
|   | | | |     | | |     |             |         | |     | |
+ +-+ +-+ + +-+-+-+ + +-+ +-+-+-+-+-+ +-+ +-+-+-+-+ + +-+ + +
|   |   | |   |   | | | | |   |     |   | |   |   | | |   | |
+-+ +-+ + +-+ + + + + + + + + + +-+ +-+ + + + + + +-+ +-+-+-+
| | |   |   | | | |   | | | |   | |     |   | | |     |     |
+ + + +-+-+ + +-+ + +-+ + +-+-+ + +-+-+-+-+-+ + + +-+-+ +-+ +
| |   |     | |   |   |   |   | |   |     | |   | | |   |   |
+ +-+-+ +-+-+ + +-+-+ +-+-+ + + +-+ +-+-+ + +-+ + + + +-+ +-+
|   |   |   |     |   |   | |   |   |   | | |   |     | |   |
+ + + +-+-+ +-+ + + +-+ + + +-+-+ +-+ + + + +-+-+-+-+-+ +-+ +
| | | |   |     | | |   | |         | | |         |   | |   |
+ +-+ + + +-+-+-+ + + +-+-+-+-+-+ + + + +-+-+-+-+ + + + + + +
|     | |         |   |       |   | | |   |   |   | |     | |
+-+-+-+ +-+-+-+-+-+-+ + +-+-+ + + + +-+-+ +-+ + + + +-+ +-+-+
|       |     |   |   |     |   | | |     |   | |   |   |   |
+ +-+-+-+-+ + + +-+ +-+-+ +-+-+-+-+ + +-+ + +-+ +-+-+ +-+-+ +
| |   |   | | |     |   |       |   |   | | |   |           |
+ + + + + + + +-+-+-+ +-+-+-+-+ + +-+-+ + + +-+ + +-+ +-+-+-+
|   |   |   | |   | |     |   | |       | |     | |   |     |
+-+-+-+-+ +-+ + + + + +-+-+ + + +-+-+-+-+-+-+-+-+ + +-+ +-+ +
|         |     |   |       |   |                 |     |    
+-+-+-+-+-+-+-+-+-+-+-+-+-+-+-+-+-+-+-+-+-+-+-+-+-+-+-+-+-+-+
