51 51
+-+-+-+-+-+-+-+-+-+-+-+-+-+-+-+-+-+-+-+-+-+-+-+-+-+
    |               |   |     |   |         |     |
+-+ + + +-+-+-+-+ + + + + + +-+ + + +-+-+ +-+ +-+ +
|   | | |   |   | |   | | |     | | |   |   | | | |
+ +-+-+ + + + + +-+-+-+ + +-+-+-+ + +-+ +-+ + + + +
|   |   | |   |     |     |   | | |   |     |   | |
+-+ + +-+-+-+ +-+-+-+ +-+-+-+ + + +-+ + +-+-+-+-+ +
| | | | |   |           |   | |   | | | |       | |
+ + + + + + +-+-+-+-+-+ + + + + +-+ + + +-+-+-+ + +
| |   |   |       |     | |   | |   | | |   |   | |
+ +-+-+-+ +-+-+-+ + +-+-+ +-+-+ + +-+ + + + + +-+ +
|   |     |     |   |   |     | | |   |   |   |   |
+-+ + +-+-+-+-+ + +-+-+ + +-+ + + +-+ +-+-+-+-+ +-+
|       |   |   |   |   |   |   |       |   |   | |
+-+-+ + +-+ + +-+-+ + +-+-+ + +-+-+-+ +-+ + + +-+ +
|     | |   |     | |       | |   |   |   |   |   |
+ +-+-+ + +-+-+-+ + +-+-+-+-+ + + + +-+ +-+-+-+-+ +
| |     | |   | | | |   |   | | | |             | |
+ + +-+-+ + + + + + + + + + + +-+ +-+ + +-+-+-+ + +
| | |   | | | | | | | | | | |     |   | |       | |
+ + +-+ + + + + + +-+ + + + +-+-+-+-+-+ +-+-+-+-+ +
| |         |   |   | | | |     |     |   | |     |
+ +-+-+-+ +-+-+-+-+ + + +-+ +-+ + +-+ +-+ + + +-+-+
|   |           |   | |   |   |   |   |     |   | |
+-+ +-+-+-+-+-+-+ + +-+ + +-+ +-+-+ +-+-+-+ + + + +
|   |     |     | | |   |   | |     |   | | | | | |
+ +-+ +-+ + +-+ + + + +-+-+ +-+ +-+-+ + + + + + + +
|   | | |   |   | | |     |     |   | | | | | | | |
+-+ + + + +-+ +-+-+ +-+-+ +-+-+-+ + + + + + +-+ + +
|   | |   |   | |   |   |         |   | |     | | |
+ +-+ +-+-+ +-+ + +-+ + +-+-+-+ +-+-+-+ +-+ + + + +
|     |     |   |     |     |   |     |   | | |   |
+-+-+-+ +-+-+ +-+-+ +-+-+-+ + + + +-+-+-+ +-+ +-+ +
|     |   | |       |     | | | |       | |     | |
+ +-+ +-+ + +-+ + +-+ +-+ + + +-+-+-+-+ + + +-+ + +
| | | | |       |   |   |   | |     | | |   |     |
+ + + + +-+ +-+-+-+ +-+-+-+-+ + +-+ + + +-+-+ + +-+
| |   |     |   | |   |       | |   | |   | | |   |
+ +-+-+-+-+-+ + + +-+ + +-+-+-+-+ +-+ +-+ + + +-+-+
| |       |   |     | | |   |       |       | |   |
+ + + +-+ + + +-+-+-+ + +-+ +-+-+ + +-+-+ +-+ + + +
|   |   |   |           |   |     |       | | | | |
+-+-+-+ +-+-+-+-+-+-+ +-+ +-+ + +-+-+-+-+-+ + +-+ +
|   |   |     |     |     |   | |     |   |       |
+ + + +-+ +-+ + +-+ +-+ +-+ +-+ + +-+ +-+ +-+ +-+-+
| |   | |   | | |   |   | | | |   | |     |   |   |
+ +-+-+ + +-+ +-+ +-+ +-+ + + +-+-+ +-+-+-+ +-+ + +
| |   |   |   |   |   |   |           |   |   | | |
+ + + +-+ + +-+ + + +-+ + +-+ +-+-+-+ + + + + + + +
|   |     |     | |     |     |       | |   |   |  
+-+-+-+-+-+-+-+-+-+-+-+-+-+-+-+-+-+-+-+-+-+-+-+-+-+